007FA3C0
007FAFC0
007FB8C0
007FBAC0
007FBCC0
007FBEC0
007FC0C0
007FC2C0
007FC4C0
007FC6C0
007FC8C0
007FCDC0
007FD2C0
007FD7C0
007FDDC0
007FE1C0
007FE6C0
007FEBC0
007FEFC0
007FF3C0
007FF7C0
007FFCC0
008000C0
008004C0
008008C0
00800DC0
008010C0
008014C0
008018C0
00801EC0
008021C0
00802DC0
008031C0
008035C0
008039C0
00803DC0
008049C0
00804EC0
008055C0
00805FC0
00806AC0
00806DC0
008071C0
008075C0
008078C0
00807BC0
00807EC0
008080C0
008082C0
008084C0
008086C0
008089C0
00808CC0
00808EC0
008090C0
008092C0
008094C0
008162C0
0081F6C0
008202C0
008209C0
00820AC0
00820FC0